..............................
..............................
..........................#...
..............................
.........................#....
..............................
........................#.....
..............................
.......................#......
..............................
......................#.......
......................#.......
.....................#........
....................#.........
..............................
.............................#
..............................
..............................
...................#####......
##############################
