##......#......#..#.........#.
.......#......................
.......#......#..#.#..........
........#.....................
.....#.....#............#.....
..#.#.#.#.................#...
#........#..#..........#......
..............##....#...#.....
##............##............#.
..#...........#....#..#.....#.
#..#...##..........#.....##..#
...#.......#..#...#.........#.
................#..#....#.....
......#......#.............#..
.........##.........#.#....#..
.....#....##....###......#..#.
.............................#
.........#.#.##......##......#
....#........#.....#..#.......
...##................#........
.#...#............#....#...#..
................#.......#....#
..................#.........#.
........#....#..........#.....
..#............#..............
...#.......#..................
.......#.......#.....#...#....
............#.....#..........#
....................#...#.....
.......................#......
.....................#..#.....
.#............#...........#...
#...#..................#......
......#.......................
......#.......................
.#...............#.....#......
........#........#............
...........#..................
#.......#.........#.....#.....
...#..........#..#......##....
........#.......#...#.........
........#......#..............
#..................#..........
............##............#...
....#............#............
##.......#...............##...
..#...............#...........
....#............##...........
...#...#......#...............
..............#......#.....#..
...............#........#.....
.....#.#..................##..
........#.........#.........##
#....#.......#..#.............
....#......#..................
#....#......................##
.........#..............##....
.#....#....#..............#...
....................#....#.#..
............#.........###.#...
..........#.........#.........
.#......##.#.#............##..
...#......#.#......#........#.
.#.##.......#.....#.....#.....
......#........#.....#.....#.#
..................#..#....#...
....#...............#.........
......................#.......
..#................#.......#..
...............#..............
....#.........................
.#......#.....................
.#....#.....#......#.......#..
.......#................#..#..
.............#...##...#....#..
...#...#....#........#....#...
...........#..............#...
...........#..............#...
.......#...#....#...#.........
...#..........#..#.#..........
.......#......................
#...#..............#..........
.....................#.#......
...#..........#........#..#.#.
.............#...#....#.......
.........#................#...
.............#.....#......#...
..................#..#.....#..
................#.............
.......#.........##...........
...#........#......#.......#..
.......................#......
...#.#..#.#.....###..#........
.........#................#...
......#....#.....#...#........
....#..#.#..#......#..........
...#..........................
.....#......#........#..#.#..#
...#...#...............#.....#
.................#............
.#...#.....#............#.....
.#...#...........#............
.#.................#....#.#...
..#....#.........#....#.......
...........................#..
.............#................
#............#................
......#....#........#.........
.............#.#........#.....
......#....#..#....#....#.....
.#.#....#....##...............
........#.#....#....#.........
..............#.....#....##...
.........#..................#.
....#......##......#......#...
..............................
...##.........................
...#.............#............
.......#......................
.........#...#.#.......#......
.......##.#.................#.
.#................#...#..##...
....#..........#..#...........
###.##.#..............#.......
....#..................#......
###..#.#.........#........#...
...#..........................
................#....#...#...#
...#..#....#...........#..#.#.
........#..................###
..............................
..........#...................
.......#...................#..
#....#..............#.........
............................#.
....#..#...#.#..#..###........
......#.......................
...................#....#.....
.......#................#..#.#
.#..#....##...#...............
............#.##............##
..#...#............#..#...#...
..#..............#...#.......#
....#.#.#........#......#.....
...............#..#.........#.
..........#........#..........
............#...............#.
...............#.....#......#.
...#.........................#
.#..........##....#..#........
.............#........#..#...#
.......#.....#...#.##...#...#.
......#...#....#....#........#
...#.....#.....#..#..#........
.......................#......
..................#...#....#..
.................#.....##.....
.#...#.............#...#.....#
........#.....................
........#.....##..............
##....#..#..#.......#.........
...........#..........#...#...
.......#..................#...
##...#.#.....#...........#....
.#............................
..........#......#........#...
..............#...........#.#.
.....#....................#..#
..##..............#...........
#.......................#.....
....#...#...#...#.#.#...#.....
#.......#.....................
.....##..#....#...............
...........#......#........#..
.............#......##........
#...................##....#.#.
.#........#..#................
......#...............#.#.....
..........#..........#........
.....##........#..............
.......#......................
#............#.#....###....#..
............#.......#...#.....
.......#........#............#
.....#..#...............#....#
..#.......#......#.....#.#....
..#.#.................#......#
..#..##.#.....................
...#........#.....#...........
#.......###..##..#............
..............................
.........#....................
.#.#.........#.#.....#......#.
.....#............#.......#..#
................#............#
...#.....#.....#....#..#....#.
............#.#...............
...#.............#.#.##....#..
...#..............#..........#
##############################
